15 9
0 0 0 0 0 0 0 0 0
0 0 0 1 4 1 0 0 0
0 0 0 1 2 1 0 0 0
0 0 0 1 0 1 0 0 0
2 1 1 1 0 1 1 1 2
0 1 2 0 0 0 2 1 0
0 1 0 0 0 0 0 1 0
0 1 2 0 0 0 2 1 0
0 1 0 0 0 0 0 1 0
0 1 2 0 0 0 2 1 0
2 1 1 1 0 1 1 1 2
0 0 0 1 1 1 0 0 0
0 0 0 2 1 2 0 0 0
0 0 0 0 3 0 0 0 0
0 0 0 0 0 0 0 0 0

2

19
13 4
12 4
11 4
11 3
10 3
10 2
10 1
9 1
8 1
7 1
6 1
5 1
4 1
4 2
4 3
3 3
2 3
1 3
1 4
4
1 3
3 1
1 3
5 1

19
13 4
12 4
11 4
11 5
10 5
10 6
10 7
9 7
8 7
7 7
6 7
5 7
4 7
4 6
4 5
3 5
2 5
1 5
1 4
2
2 3
4 3
